太阳病 汗出 烦渴 脉象洪大	知母 石膏 甘草 粳米 人参
发热 恶风 口渴 口干舌燥	知母 石膏 甘草 粳米 人参
无高热 口干舌燥 心烦 背寒	知母 石膏 甘草 粳米 人参
口渴 无发热 不怕冷	知母 石膏 甘草 粳米 人参
口渴 口干舌燥	知母 石膏 甘草 粳米 人参
脉象浮滑 发热	知母 石膏 甘草 粳米
寒实结胸 无发热	桔梗 巴豆 贝母
腹泻不止 厥冷 无脉 干呕 烦躁	葱白 干姜 附子 人尿 猪胆汁
少阴病 下痢	葱白 干姜 附子
少阴病 下痢 脉象微弱	葱白 干姜 附子
发热 下利下重	白头翁 黄柏 黄连 秦皮
少阴病 咽喉疼痛	半夏 桂枝 甘草
心下痞满	半夏 黄芩 干姜 人参 甘草 黄连 大枣
胸胁胀满 小便不利 口渴 无呕吐 头汗 寒热交替 心烦	柴胡 桂枝 干姜 栝楼根 黄芩 牡蛎 甘草
胸胁胀满 呕吐 潮热 轻微腹泻	柴胡 黄芩 人参 甘草 生姜 半夏 大枣 芒硝
伤寒 发热 汗出 心下痞硬 呕吐 下痢	柴胡 黄芩 芍药 半夏 生姜 枳实 大枣 大黄
大便不通 潮热 不怕冷 神志不清 发热 谵语	大黄 厚朴 枳实 芒硝
谵语 潮热 食欲不振 燥屎	大黄 厚朴 枳实 芒硝
谵语 燥屎	大黄 厚朴 枳实 芒硝
阳明病 心烦 燥屎	大黄 厚朴 枳实 芒硝
烦躁 发热 心悸 脉象坚实有力	大黄 厚朴 枳实 芒硝
大便不通 烦躁 腹部硬满 腹痛	大黄 厚朴 枳实 芒硝
大便不通 小便正常 食欲不振	大黄 厚朴 枳实 芒硝
阳明病 发热 多汗	大黄 厚朴 枳实 芒硝
腹胀	大黄 厚朴 枳实 芒硝
少阴病 口干舌燥	大黄 厚朴 枳实 芒硝
少阴病 腹胀 大便不通	大黄 厚朴 枳实 芒硝
脉象浮紧 发热 恶寒 身痛 无汗 烦躁	麻黄 桂枝 甘草 杏仁 生姜 大枣 石膏
脉象浮缓 身重	麻黄 桂枝 甘草 杏仁 生姜 大枣 石膏
胸膈疼痛 气短 烦躁 心烦 心下坚硬	大黄 芒硝 甘遂
发热 脉象沉紧 心下坚硬	大黄 芒硝 甘遂
结胸 无高热 头汗	大黄 芒硝 甘遂
大便不通 口干舌燥 潮热 心下坚硬 小腹坚硬	大黄 芒硝 甘遂
心下痞满	大黄 芒硝 甘遂
结胸 颈项强直	大黄 葶苈子 芒硝 杏仁 甘遂 白蜜
四肢厥冷 脉象沉细	当归 桂枝 芍药 细辛 甘草 通草 大枣
发热 小腹胀满 小便正常	水蛭 虻虫 桃仁 大黄
谵语	大黄 甘草 芒硝
发热	大黄 甘草 芒硝
心烦	大黄 甘草 芒硝
持续发热	大黄 甘草 芒硝
腹胀	大黄 甘草 芒硝
伤寒 汗出 不口渴	茯苓 桂枝 甘草 生姜
厥冷 心悸	茯苓 甘草 生姜 桂枝
心下痞满 气冲胸 头晕目眩 脉象沉紧	茯苓 桂枝 白术 甘草
烦躁	茯苓 人参 附子 甘草 干姜
少阴病 背寒	附子 茯苓 人参 白术 芍药
少阴病 身痛 四肢厥冷 关节痛 脉象沉	附子 茯苓 人参 白术 芍药
心下痞 恶寒 汗出	大黄 黄连 黄芩 附子
关节痛 四肢拘挛 汗出 气短 小便不利 恶风	甘草 附子 白术 桂枝
脉象浮 自汗 尿频 心烦 轻微怕冷 脚部痉挛 厥冷 咽喉干燥 烦躁 呕吐 气逆	甘草 干姜
少阴病 咽喉疼痛	甘草
下利清谷 腹部雷鸣 心下痞硬 干呕 心烦	甘草 人参 干姜 黄芩 半夏 黄连 大枣
烦躁 失眠 无呕吐 不口渴 脉象沉微 无高热	干姜 附子
食入即吐 下痢	干姜 黄芩 黄连 人参
腹泻不止 脉搏急促 喘息 汗出	葛根 甘草 黄芩 黄连
太阳阳明合病 呕吐	葛根 麻黄 桂枝 生姜 甘草 芍药 大枣 半夏
太阳病 颈项强直 无汗 恶风	葛根 麻黄 桂枝 生姜 甘草 芍药 大枣
发热 恶寒 类似疟疾	桂枝 芍药 麻黄 生姜 杏仁 甘草 大枣
发热 恶寒 热多寒少 脉象微弱	桂枝 芍药 麻黄 甘草 大枣 生姜 石膏
汗出不止 心悸	桂枝 甘草
腹胀 腹痛	桂枝 芍药 甘草 生姜 大枣 大黄
头痛 发热 恶风 汗出不止 小便不利 四肢拘挛	桂枝 芍药 甘草 生姜 大枣 附子
太阳病 颈项强直 汗出 恶风	桂枝 芍药 甘草 生姜 大枣 葛根
轻微喘息 发热 汗出 恶风 脉象浮	桂枝 芍药 甘草 生姜 大枣 厚朴 杏仁
汗出 身痛 脉象沉迟	桂枝 芍药 甘草 人参 大枣 生姜
腹胀 腹痛	桂枝 芍药 甘草 生姜 大枣
发热 恶寒 类似疟疾 热多寒少 无呕吐 小便正常 面色热	桂枝 芍药 生姜 甘草 麻黄 大枣 杏仁
太阳病 脉搏急促 胸满 轻微怕冷	桂枝 甘草 生姜 大枣 附子
惊悸 坐卧不宁	桂枝 甘草 生姜 大枣 牡蛎 蜀漆 龙骨
太阳病 脉搏急促 胸满	桂枝 甘草 生姜 大枣
发热 腹泻不止 心下痞硬	桂枝 甘草 白术 人参 干姜
太阳病 头痛 发热 汗出 恶风	桂枝 芍药 甘草 生姜 大枣
太阳病 气冲胸	桂枝 芍药 甘草 生姜 大枣
伤寒 大便不通 头痛 发热 小便正常	桂枝 芍药 甘草 生姜 大枣
自汗	桂枝 芍药 甘草 生姜 大枣
间歇性发热 自汗	桂枝 芍药 甘草 生姜 大枣
伤寒 身痛 小便正常	桂枝 芍药 甘草 生姜 大枣
太阳病 发热 汗出	桂枝 芍药 甘草 生姜 大枣
心下痞 恶寒 发热	桂枝 芍药 甘草 生姜 大枣
泻下后腹部胀满 身痛	桂枝 芍药 甘草 生姜 大枣
汗出 胸腹胀满	厚朴 生姜 半夏 甘草 人参
发热 轻微怕冷 四肢关节疼痛 轻微呕吐 心下不适	桂枝 黄芩 人参 甘草 半夏 芍药 大枣 生姜 柴胡
少阴病 心烦 失眠	黄连 黄芩 芍药 鸡子 阿胶
体内有热 腹痛 欲呕	黄连 甘草 干姜 桂枝 人参 半夏 大枣
少阴病 咽喉疼痛	桔梗 甘草
口水频吐	人参 干姜 甘草 白术
少阴病	麻黄 甘草 附子
伤寒 身体发黄	麻黄 连轺 杏仁 赤小豆 大枣 生梓白皮 生姜 甘草
头痛 发热 身痛 四肢关节疼痛 恶风 无汗 气喘	麻黄 桂枝 甘草 杏仁
太阳阳明合病 喘息 胸满	麻黄 桂枝 甘草 杏仁
脉象浮紧 无汗 发热 身痛 烦躁 头晕目眩 鼻衄	麻黄 桂枝 甘草 杏仁
伤寒 脉象浮数 鼻衄	麻黄 桂枝 甘草 杏仁
脉象浮	麻黄 桂枝 甘草 杏仁
阳明病 脉象浮 无汗 气喘	麻黄 桂枝 甘草 杏仁
少阴病 发热 脉象沉	麻黄 细辛 附子
汗出 喘息 无高热	麻黄 杏仁 甘草 石膏
趺阳脉浮涩 尿频 大便硬结	麻子仁 芍药 枳实 大黄 厚朴 杏仁 白蜜
身痛 无呕吐 不口渴 大便硬结 小便正常	附子 白术 生姜 大枣 甘草
汗出 恶寒	芍药 甘草 附子
心下痞硬 嗳气 消化不良 胁下积水 腹部雷鸣 下痢	生姜 甘草 人参 干姜 黄芩 半夏 黄连 大枣
头痛 心下痞硬 心下痞满 胁痛 干呕 气短 汗出 不怕冷	芫花 甘遂 大戟 大枣
恶寒 脉象微弱 腹泻停止	甘草 干姜 附子 人参
四肢厥冷	甘草 枳实 柴胡 芍药
四肢厥冷 小便不利	甘草 枳实 柴胡 芍药 茯苓
四肢厥冷 腹痛	甘草 枳实 柴胡 芍药 附子
四肢厥冷 心悸	甘草 枳实 柴胡 芍药 桂枝
四肢厥冷 咳嗽	甘草 枳实 柴胡 芍药 五味子 干姜
下利清谷 身痛	甘草 干姜 附子
发热 头痛 脉象沉 身痛	甘草 干姜 附子
脉象沉迟 下利清谷	甘草 干姜 附子
少阴病 脉象沉	甘草 干姜 附子
汗出 发热 腹部不适 四肢关节疼痛 下痢 厥冷 恶寒	甘草 干姜 附子
多汗 腹泻不止 厥冷	甘草 干姜 附子
下痢 腹胀 身痛	甘草 干姜 附子
呕吐 脉象微弱 小便正常 轻微发热 厥冷	甘草 干姜 附子
呕吐 下痢 汗出 发热 恶寒 四肢拘挛 四肢厥冷	甘草 干姜 附子
呕吐 下痢 尿频 汗出 下利清谷 发热 脉象微弱	甘草 干姜 附子
少阴病 下痢 脓血便	赤石脂 干姜 粳米
少阴病 腹痛 小便不利 腹泻不止 脓血便	赤石脂 干姜 粳米
少阴病 下利清谷 四肢厥冷 脉象微弱 不怕冷	甘草 附子 干姜
下利清谷 汗出 厥冷	甘草 附子 干姜
少阴病 下利清谷 四肢厥冷 脉象微弱 不怕冷 咽喉疼痛	甘草 附子 干姜 桔梗
少阴病 下利清谷 四肢厥冷 脉象微弱 不怕冷 腹痛	甘草 附子 干姜 芍药
少阴病 下利清谷 四肢厥冷 脉象微弱 不怕冷 干呕	甘草 附子 干姜 生姜
食入即吐	吴茱萸 人参 生姜 大枣
呕吐 下痢 四肢厥冷 烦躁	吴茱萸 人参 生姜 大枣
干呕 口水频吐 头痛	吴茱萸 人参 生姜 大枣
脉象浮 小便不利 轻微发热 消渴	猪苓 泽泻 白术 茯苓 桂枝
脉象浮数 烦渴	猪苓 泽泻 白术 茯苓 桂枝
伤寒 汗出 口渴	猪苓 泽泻 白术 茯苓 桂枝
心下痞 口干舌燥 口渴 小便不利	猪苓 泽泻 白术 茯苓 桂枝
口渴	猪苓 泽泻 白术 茯苓 桂枝
寒热交替 胸胁胀满 食欲不振 心烦 恶心	柴胡 黄芩 人参 半夏 甘草 生姜 大枣
伤寒 腹部急痛	柴胡 黄芩 人参 半夏 甘草 生姜 大枣
头汗 轻微怕冷 四肢厥冷 心下痞满 食欲不振 大便硬结 脉象沉细	柴胡 黄芩 人参 半夏 甘草 生姜 大枣
伤寒 呕吐 发热	柴胡 黄芩 人参 半夏 甘草 生姜 大枣
潮热 粪便清稀 小便正常 胸胁胀满	柴胡 黄芩 人参 半夏 甘草 生姜 大枣
胸胁胀满 干呕 食欲不振 寒热交替 脉象沉紧	柴胡 黄芩 人参 半夏 甘草 生姜 大枣
呕吐 发热	柴胡 黄芩 人参 半夏 甘草 生姜 大枣
伤寒 发热	柴胡 黄芩 人参 半夏 甘草 生姜 大枣
寒热交替 胸胁胀满 食欲不振 心烦 恶心 口渴	柴胡 黄芩 人参 甘草 生姜 大枣 栝楼根
寒热交替 胸胁胀满 食欲不振 心烦 恶心 胸闷 无呕吐	柴胡 黄芩 甘草 生姜 大枣 瓜蒌实
寒热交替 胸胁胀满 食欲不振 心烦 恶心 胁胀	柴胡 黄芩 人参 半夏 甘草 生姜 牡蛎
寒热交替 胸胁胀满 食欲不振 心烦 恶心 心下悸动 小便不利	柴胡 茯苓 人参 半夏 甘草 生姜 大枣
寒热交替 胸胁胀满 食欲不振 心烦 恶心 腹痛	柴胡 人参 半夏 甘草 生姜 大枣 芍药
寒热交替 胸胁胀满 食欲不振 心烦 恶心 咳嗽	柴胡 黄芩 半夏 甘草 五味子 干姜
寒热交替 胸胁胀满 食欲不振 心烦 恶心 不口渴 轻微发热	柴胡 黄芩 桂枝 半夏 甘草 生姜 大枣
多汗 轻微发热 恶寒 腹胀 大便不通	大黄 厚朴 枳实
发热 大便不通	大黄 厚朴 枳实
发热 大便秘结	大黄 厚朴 枳实
多汗 大便秘结 谵语	大黄 厚朴 枳实
心烦 尿频 大便秘结	大黄 厚朴 枳实
脉象微弱 烦躁 心下坚硬	大黄 厚朴 枳实
下痢 谵语	大黄 厚朴 枳实
恶寒 水饮停滞 干呕 发热 咳嗽	麻黄 芍药 细辛 干姜 甘草 桂枝 五味子 半夏
伤寒 水饮停滞 咳嗽 轻微喘息 发热 不口渴	麻黄 芍药 细辛 干姜 甘草 桂枝 五味子 半夏
恶寒 水饮停滞 干呕 发热 咳嗽 口渴	麻黄 芍药 细辛 干姜 甘草 桂枝 五味子 栝楼根
恶寒 水饮停滞 干呕 发热 咳嗽 小便不利 小腹胀满	芍药 细辛 干姜 甘草 桂枝 五味子 半夏 茯苓
恶寒 水饮停滞 干呕 发热 咳嗽 噎食	芍药 细辛 干姜 甘草 桂枝 五味子 半夏 附子
恶寒 水饮停滞 干呕 发热 咳嗽 喘息	芍药 细辛 干姜 甘草 桂枝 五味子 半夏 杏仁
恶寒 水饮停滞 干呕 发热 咳嗽 轻微腹泻	芍药 细辛 干姜 甘草 桂枝 五味子 半夏 芫花
心下不适 脉象浮滑	黄连 半夏 瓜蒌实
阳明病 头汗 无汗 头汗 小便不利 身体发黄	茵陈蒿 栀子 大黄
伤寒 身体发黄 小便不利 腹胀	茵陈蒿 栀子 大黄
太阳病 汗出 发热 心悸 头晕目眩	茯苓 芍药 生姜 白术 附子
伤寒 身体发黄 发热	栀子 甘草 黄柏
虚烦 失眠 心烦	栀子 香豉
烦躁 发热 胸口堵塞	栀子 香豉
伤寒病愈后 体内有热 心中疼痛	栀子 香豉
虚烦 失眠 心烦 气促	栀子 香豉 甘草
伤寒病愈后 体内有热 心烦	栀子 干姜
伤寒病愈后 心烦 腹部硬满 坐卧不宁	栀子 厚朴 枳实
虚烦 失眠 心烦 干呕	栀子 香豉 生姜
少阴病 下痢 咽喉疼痛 胸满 心烦	猪肤 白蜜 白粉
脉象浮 发热 口渴 小便不利	猪苓 茯苓 泽泻 阿胶 滑石
少阴病 下痢 咳嗽 干呕 口渴 心烦 失眠	猪苓 茯苓 泽泻 阿胶 滑石